1111111111
1000P00001
1010000C01
100C0E00C1
1111111111
