1111111111111
10010000000C1
1000011111001
1P0011E000001
1000000000001
1000000000C01
1000000000C01
1000000000C01
1000000000C01
1000000000C01
1000000000C01
1000000000C01
1000000000C01
1000000000C01
1000000000C01
1000100000C01
1000000000C01
1000000000C01
1000000000C01
1000000000C01
1001000000C01
1000000000C01
1111111111111
