111111111
1000p00001
1010000C01
100c0E00C1
1111111111
