1111111111
1000p00001
101000XC01
100c0E00C1
1111111111
