1111111111
1000p00C01
1001000C01
10000E0001
1111111111
