1111111111
1000P00C01
1001000001
100P0E0001
1111111111
