1111011111
1000p00C01
1001000001
10000E0001
1111111111
